ADP| ADP
AED| AED
AFA| AFA
ALL| ALL
AMD| AMD
ANG| ANG
AON| AON
AOR| AOR
ARS| ARS
ATS| ATS
AUD| AUD
AWG| AWG
AZM| AZM
BAM| BAM
BBD| BBD
BDT| BDT
BEF| BEF
BGL| BGL
BHD| BHD
BIF| BIF
BMD| BMD
BND| BND
BOB| BOB
BOV| BOV
BRL| BRL
BSD| BSD
BTN| BTN
BWP| BWP
BYB| BYB
BZD| BZD
CAD| CAD
CHF| CHF
CLF| CLF
CLP| CLP
CNY| CNY
COP| COP
CRC| CRC
CUP| CUP
CVE| CVE
CYP| CYP
CZK| CZK
DEM| DEM
DJF| DJF
DKK| DKK
DOP| DOP
DZD| DZD
ECS| ECS
ECV| ECV
EEK| EEK
EGP| EGP
ERN| ERN
ESP| ESP
ETB| ETB
EUR| EUR
FIM| FIM
FJD| FJD
FKP| FKP
FRF| FRF
GBP| GBP
GEL| GEL
GHC| GHC
GIP| GIP
GMD| GMD
GNF| GNF
GRD| GRD
GTQ| GTQ
GWP| GWP
GYD| GYD
HKD| HKD
HNL| HNL
HRK| HRK
HTG| HTG
HUF| HUF
IDR| IDR
IEP| IEP
ILS| ILS
INR| INR
IQD| IQD
IRR| IRR
ISK| ISK
ITL| ITL
JMD| JMD
JOD| JOD
JPY| JPY
KES| KES
KGS| KGS
KHR| KHR
KMF| KMF
KPW| KPW
KRW| KRW
KWD| KWD
KYD| KYD
LAK| LAK
LBP| LBP
LKR| LKR
LRD| LRD
LSL| LSL
LTL| LTL
LUF| LUF
LVL| LVL
LYD| LYD
MAD| MAD
MDL| MDL
MGF| MGF
MKD| MKD
MMK| MMK
MNT| MNT
MOP| MOP
MRO| MRO
MTL| MTL
MUR| MUR
MVR| MVR
MWK| MWK
MXN| MXN
MXV| MXV
MYR| MYR
MZM| MZM
NAD| NAD
NGN| NGN
NIO| NIO
NLG| NLG
NOK| NOK
NPR| NPR
NZD| NZD
OMR| OMR
PAB| PAB
PEN| PEN
PGK| PGK
PHP| PHP
PKR| PKR
PLN| PLN
PTE| PTE
PYG| PYG
QAR| QAR
ROL| ROL
RUB| RUB
RWF| RWF
SAR| SAR
SBD| SBD
SCR| SCR
SDD| SDD
SEK| SEK
SGD| SGD
SHP| SHP
SIT| SIT
SKK| SKK
SLL| SLL
SOS| SOS
SRG| SRG
STD| STD
SVC| SVC
SYP| SYP
SZL| SZL
THB| THB
TJR| TJR
TMM| TMM
TND| TND
TOP| TOP
TPE| TPE
TRL| TRL
TTD| TTD
TWD| TWD
TZS| TZS
UAH| UAH
UGX| UGX
USD| USD
USN| USN
UYU| UYU
UZS| UZS
VEB| VEB
VND| VND
VUV| VUV
WST| WST
XAF| XAF
XAG| XAG
XAU| XAU
XBA| XBA
XBB| XBB
XBC| XBC
XBD| XBD
XCD| XCD
XDR| XDR
XEU| XEU
XFO| XFO
XFU| XFU
XOF| XOF
XOP| XOP
XPD| XPD
XPF| XPF
XPT| XPT
XXX| XXX
YER| YER
YUM| YUM
ZAR| ZAR
ZMK| ZMK
ZRN| ZRN
ZWD| ZWD
RSD| RSD
